0 0 0 0 0 0 0 0 0 0 0 0 0 0 0 0 0 0 0 0 0 0 0 0 0 0 0 0 0 0 0
0 0 0 0 0 0 0 0 0 0 0 0 0 0 0 0 0 0 0 0 0 0 0 0 0 0 0 0 0 0 0
0 0 0 0 0 0 0 0 0 0 0 0 0 0 0 0 0 0 0 0 0 0 0 0 0 0 0 0 0 0 0
0 0 0 S S S S S S S S S S S S S S S S S S S S S S 0 0 0 0 0 0
0 0 0 0 0 0 0 0 I I I I I I I I I I I I I I I I S 0 0 0 0 0 0
0 0 0 R R R R 0 I I I I I I I R I I I I I I R I S 0 0 0 0 0 0
0 0 0 0 0 R 0 I I I I R I I I I I I I I I I I I S 0 0 0 0 0 0
0 0 0 0 0 R I I I I R I I I I R I I I I I I I I S 0 0 0 0 0 0
0 0 0 0 0 0 I I I I I I I I I I I I I I I I I I S 0 0 0 0 0 0
0 0 0 0 S I I I I I I I I I I I I I I I I R R I S 0 0 0 0 0 0
0 0 0 0 S I I I I I I I I I I I I I I I I I I I S 0 0 0 0 0 0
0 0 0 0 S I I I I I I I I I I R I I I I I I I I S 0 0 0 0 0 0
0 0 0 0 S I I I I I I I I I 0 X 0 I I I I I I I S 0 0 0 0 0 0
0 0 0 0 S I I I I I I I I I 0 0 0 I I I I I I I S 0 0 0 0 0 0
0 0 0 0 S I I I I I I I I I I R I I I I I I I I S 0 0 0 0 0 0
0 0 0 0 S I I I I I I I I I I I I I I I I I I I S 0 0 0 0 0 0
0 0 0 0 S I R I I I R I I I I I I I I I I I I I S 0 0 0 0 0 0
0 0 0 0 S I I I I I I I I I I I I I I I I I I I S 0 0 0 0 0 0
0 0 0 0 S I I I I I I I I I I R I I I I I R I I S 0 0 0 0 0 0
0 0 0 0 S I I I I I I I I I I I I I I I I I I I S 0 0 0 0 0 0
0 0 0 0 S I I I I I I I I I I I I I I I I I I I S 0 0 0 0 0 0
0 0 0 0 S I R I I I I I I I I R I I I I I I I I S 0 0 0 0 0 0
0 0 0 0 S I I I I I I I I I I I I I I I I I I I S 0 0 0 0 0 0
0 0 0 0 S I I I I I I I I I I I I I I I I I I I S 0 0 0 0 0 0
0 0 0 0 S S S S S S S S S S S S S S S S S S S S S 0 0 0 0 0 0
0 0 0 0 0 0 0 0 0 0 0 0 0 0 0 0 0 0 0 0 0 0 0 0 0 0 0 0 0 0 0
0 0 0 0 0 0 0 0 0 0 0 0 0 0 0 0 0 0 0 0 0 0 0 0 0 0 0 0 0 0 0
0 0 0 0 0 0 0 0 0 0 0 0 0 0 0 0 0 0 0 0 0 0 0 0 0 0 0 0 0 0 0
0 0 0 0 0 0 0 0 0 0 0 0 0 0 0 0 0 0 0 0 0 0 0 0 0 0 0 0 0 0 0
0 0 0 0 0 0 0 0 0 0 0 0 0 0 0 0 0 0 0 0 0 0 0 0 0 0 0 0 0 0 0
0 0 0 0 0 0 0 0 0 0 0 0 0 0 0 0 0 0 0 0 0 0 0 0 0 0 0 0 0 0 0



