0 0 0 0 0 0 0 0 0 0 0 0 0 0 0 0 0 0 0 0 0 0 0 0 0 0 0 0 0 0 0
0 0 0 0 0 0 0 0 0 0 0 0 0 0 0 0 0 0 0 0 0 0 0 0 0 0 0 0 0 0 0
0 0 0 0 0 0 0 0 0 0 0 0 0 0 0 0 0 0 0 0 0 0 0 0 0 0 0 0 0 0 0
0 0 0 H 0 0 0 0 0 0 0 R R R 0 0 0 0 0 0 0 0 0 0 0 0 0 0 0 0 0
0 0 0 R 0 0 0 0 0 0 0 R 0 R R 0 0 0 0 0 0 0 0 0 0 0 0 0 0 0 0
0 0 0 R 0 0 0 T R R R R R 0 R R R R F R R R R R R R R 0 0 0 0
0 0 0 R 0 0 0 0 0 0 0 0 D 0 0 0 0 0 0 0 0 0 0 0 0 0 R 0 0 0 0
0 0 0 K R R R R R R R R R R R 0 0 0 0 0 0 0 0 0 0 0 R 0 0 0 0
0 0 0 0 0 0 0 0 0 D 0 0 0 0 0 0 0 0 0 0 0 0 0 0 0 R R 0 0 0 0
0 0 0 0 0 0 0 0 R R 0 0 0 0 R R R R R 0 0 0 0 R R R 0 0 0 0 0
0 0 0 0 0 0 0 R R 0 0 0 0 0 F 0 0 R 0 0 0 0 R R R 0 0 0 0 0 0
0 0 0 0 0 0 R R 0 0 0 0 0 0 R 0 0 R R 0 0 R R 0 R 0 0 0 0 0 0
0 0 0 0 0 R R 0 0 0 0 0 0 0 R 0 0 R 0 0 0 R 0 0 R R 0 0 0 0 0
0 0 0 0 0 R 0 0 0 0 0 0 0 R R 0 R R 0 0 0 R 0 0 0 R 0 0 0 0 0
0 0 0 0 0 R R R R R R R R R 0 0 0 0 0 K R R 0 0 0 R R R 0 0 0
0 0 0 0 0 R 0 0 0 0 0 0 0 0 0 0 0 0 0 0 0 0 0 0 0 0 0 R 0 0 0
0 0 0 0 R R 0 R R R R R R R R R R R R R R R K R 0 0 0 R 0 0 0
0 0 0 0 R 0 0 R 0 0 0 0 0 0 0 0 0 0 0 R 0 0 0 0 0 0 0 R 0 0 0
0 0 0 0 R 0 R R 0 R R R R R R R R R 0 R 0 0 0 0 0 0 0 F 0 0 0
0 0 0 0 R 0 R 0 0 R 0 0 0 0 0 0 0 0 0 R 0 0 0 0 R R R R 0 0 0
0 0 0 0 R 0 R 0 0 R 0 0 R R R R R R R R 0 0 0 0 R 0 0 0 0 0 0
0 0 0 0 R 0 R 0 0 R 0 0 R 0 0 0 0 0 0 0 0 0 0 0 R R R R 0 0 0
0 0 0 0 R R R R R R 0 0 R R R R R R R R R R 0 0 0 0 0 R 0 0 0
0 0 0 0 0 0 0 0 0 0 R 0 0 0 0 0 0 0 0 0 0 F 0 0 0 0 0 R 0 0 0
0 0 0 X R R R R 0 0 R 0 R R R R 0 0 0 R D R 0 0 R R R R 0 0 0
0 0 0 0 D 0 0 0 0 0 R 0 0 R 0 0 0 0 R R 0 0 0 R R 0 0 0 0 0 0
0 0 0 G R R R R R R R R R R R R R R R R R 0 0 0 K R 0 0 0 0 0
0 0 0 0 0 0 0 0 0 0 0 0 0 0 0 0 0 0 0 0 0 0 0 0 0 0 0 0 0 0 0
0 0 0 0 0 0 0 0 0 0 0 0 0 0 0 0 0 0 0 0 0 0 0 0 0 0 0 0 0 0 0
0 0 0 0 0 0 0 0 0 0 0 0 0 0 0 0 0 0 0 0 0 0 0 0 0 0 0 0 0 0 0
0 0 0 0 0 0 0 0 0 0 0 0 0 0 0 0 0 0 0 0 0 0 0 0 0 0 0 0 0 0 0